argument - විස්තාරය
repository - නිධිය
file - ගොනුව
token - ටෝකනය
cache - හැඹිලිය
model - ආකෘතිය
interface - අතුරු මුහුණත
host - සංග්‍රාහක
hub - කේන්ද්‍රය
local - තත්
folder - ෆෝල්ඩරය
clone - ක්ලෝන
directory - නාමාවලිය
instantiating - ක්ෂණික කරන විට
documentation - ප්‍රලේඛනය
tokenizer - ටෝකනකාරක
pull - නිපතන
commit - කැප කිරීම
caveat - විරුද්ධවාවක
installation - ස්ථාපනය
configuration - වින්‍යාස /සැකසුම
artifact - මානවකෘතිය
outlier - බහිහ්ස්ථිතය
fork - කරුව
bias - පක්ෂග්‍රාහීත්වය
transformers - පරිවර්තක
objects - වස්තු
architecture - නිර්මිතය
trainer - පුහුණුකාරක
callback - යලි ඇමතුම
authenticate - සත්‍යාපනය